1110111011111111
1111111110101011
1000000000000001
11000010N0001001
1100100010000001
0011111111111110