1111111111111111
1111111110101011
1000000000000001
1100001000001001
111010000000N001
0111111111111111