NO        ./textures/bricks.xpm42
F 250,10,10
S     ./textures/brick.xpm42
C                  45,30,0
SO        ./textures/trip4.xpm42
WE        ./textures/wood.xpm42
EA ./textures/plant.xpm42



            1111111
            1000001
           1111D1111
           101000101
           10D0N0D01
           101000101
           1111D1111
            1000001
            1111111