NO ./textures/brick.xpm42
S ./textures/brick.xpm42
SO ./textures/brick.xpm42
WE ./textures/brick.xpm42
EA ./textures/brick.xpm42

C 0,0,0
F 0,0,0

        1111111111111111111111111
        1000000000000000000000001
        101100010101010000000001
        1001000000000001001000001
111111111011000101010100000000001
100000000011000000000000000011111
10110000000000000000000010001
11110000000000001101010010001
11000000000000001100000000001
10000000000000001100000010001
100000S00000000011010010010001
1100000111010101111101111000111
11110111 1110101 101111010001
11111111 1111111 111111111111

